1111111111111
10000100E0001
100P0000C1111
10000C1000111
1111111111111
