1111111111111
10100C00000C1
1E100000P0101
100000000C001
1111111111111
